D,2,0,0,0,0,0,0,0,0,0,2,2,2,2,0,0,0,0,0,0,
D,0,0,0,0,0,0,0,0,0,0,2,2,2,2,0,0,0,0,0,2I,
D,0,0,0,0,0,0,0,0,0,2,2,2,4,0,0,0,0,0,0,0,
D,2,0,2I,0,0,0,0,0,0,2,2,2,1,0,0,0,0,0,0,2,
D,0,0,0,0,0,0,0,0,0,9,0,9,0,0,0,0,0,0,0,0,
D,0,0,0,0,0,0,0,0,2,2,2,2,0,0,0,0,0,0,0,0,
D,0,3,2,0,0,0,0,0,2,0,0,2,0,0,0,0,0,0,0,0,
D,0,0,0,0,0,0,0,9,2,0,0,2,9,0,0,0,0,0,0,0,
D,0,0,0,0,0,0,0,0,2,2,2,2,0,0,0,0,0,0,0,0,
D,0,0,0,0,0,0,0,0,0,0,0,0,0,0,0,0,0,0,0,0,

Balls/2,4,TOP_LEFT/5,5,TOP_RIGHT
Snoopy/2,2