D,0,0,0,0,0,0,0,0,0,0,0,0,0,0,0,0,0,0,0,0
D,0,0,4,0,0,1,0,0,0,0,0,0,0,1,0,0,0,0,0,0
D,0,0,0,9,0,2,0,0,0,0,0,0,0,4,0,0,0,1,0,0
D,0,0,2,0,0,0,9,2,0,0,0,0,0,0,0,0,0,0,0,0
D,3,0,0,0,0,0,0,0,0,0,0,0,0,0,0,0,0,0,0,0
D,0,0,0,0,0,0,0,0,0,0,9,0,0,1,1,0,4,0,0,0
D,0,0,0,0,8,0,0,0,0,0,0,0,0,0,0,0,0,0,0,0
D,0,1,0,0,0,0,0,0,4,0,0,9,0,0,3,0,0,0,0,4
D,0,4,0,0,0,0,0,0,0,0,0,0,0,0,0,0,0,0,0,0
D,0,0,0,0,0,0,0,0,0,2,2,0,0,0,0,4,0,0,0,0

Snoopy/1,1