D,4,4,4,1,0,0,0,0,0,0,0,0,0,0,0,0,0,0,0,0
D,4,9,1,2,0,0,0,0,0,0,0,0,0,0,0,0,0,0,0,0
D,4,4,4,0,0,0,0,0,0,0,0,0,0,4,0,0,0,0,0,0
D,0,0,0,0,0,0,0,0,0,0,0,0,0,0,0,0,0,0,0,0
D,0,0,0,0,0,0,0,0,0,0,0,0,0,0,0,0,0,0,0,0
D,0,0,0,0,0,0,0,0,0,0,0,0,0,0,0,0,0,0,0,0
D,3,0,3,0,0,0,0,0,0,0,0,0,0,0,0,0,0,0,0,0
D,3,0,2,0,0,0,0,0,0,0,0,0,0,0,0,0,0,2,2,2
D,3,0,4,0,0,0,0,0,0,0,0,0,0,0,0,0,2,0,9,2
D,9,0,3,0,0,0,0,0,0,0,0,0,0,0,0,0,0,2,0,0

Balls/2,4,TOP_LEFT/3,5,TOP_RIGHT/
Snoopy/6,4