D,9,3,2,0,0,1,0,2,0,0,0,2,0,0,1,0,0,2,0,9
D,0,0,0,0,2,2,0,0,2,0,2,0,0,0,2,2,0,0,0,0
D,2,0,0,2,2,0,0,0,0,2,0,0,0,0,0,2,2,0,0,2
D,0,0,2,2,0,0,1,0,0,1,0,0,0,1,0,0,2,2,0,0
D,0,0,0,1,0,0,0,0,1,0,1,0,0,0,0,0,1,0,0,0
D,0,0,2,2,0,0,0,1,0,0,0,1,0,0,0,0,2,2,0,0
D,0,0,0,2,2,0,0,0,1,0,1,0,0,0,0,2,2,0,0,0
D,2,0,0,0,2,2,1,0,0,1,0,0,0,1,2,2,0,0,0,2
D,0,0,0,0,0,2,2,0,0,2,0,0,0,2,2,0,0,0,0,0
D,9,0,2,0,0,0,1,0,2,0,2,0,0,1,0,0,0,2,0,9

Snoopy/9,5