D,9,0,0,4,0,0,0,0,0,1,1,1,1,0,0,0,0,4,0,0
D,0,0,0,4,0,0,0,1,0,1,1,1,1,9,0,0,0,4,1,0
D,0,0,4,0,4,0,0,1,0,1,1,1,1,0,0,1,0,4,0,0
D,0,4,0,4,0,4,0,0,0,1,1,1,1,0,4,3,4,0,0,0
D,0,0,2,0,2,0,0,0,0,4,4,0,0,4,0,2,0,4,0,0
D,4,0,2,0,2,0,4,0,4,8,1,6R,6R,0,0,0,0,4,1,0
D,4,4,4,1,4,4,0,4,0,4,4,6U,9,4,0,2,0,4,0,0
D,0,0,0,0,0,0,4,0,0,0,0,0,2,0,4,0,4,0,0,0
D,0,0,0,0,0,0,0,2,2,2,2,0,0,6L,6L,1,4,0,1,0
D,9,0,0,0,0,0,4,1,1,1,1,0,0,4,0,4,0,0,0,0

Snoopy/9,5